XXXXXXXXXXXXXXXXXXXXX
X...X.............XFX
X.X.X.XXXXXXXXX.X.X.X
X.X...X.......X.X.X.X
XXXXX.X.XXXXX.X.X.X.X
X...X.X...X...X.X...X
X.X.XXXXX.X.XXX.XXX.X
X.X.......X.X...X...X
X.XXXXXXXXX.XXX.XXXXX
X.X...X...X...X.....X
X.XXX.X.X.XXX.XXXXX.X
X...X...X...........X
X.X.X.XXXXX.XXXXXXX.X
X.X.X.X...X.X.....X.X
XXX.XXX.X.XXX.XXX.XXX
X...X...X.......X...X
X.XXX.XXXXXXXXXXXXX.X
X.X...X.....X.X.....X
X.X.XXXXXXX.X.X.XXX.X
XI..........X...X...X
XXXXXXXXXXXXXXXXXXXXX